WWWWWWWWWWWWWWW
W     B  B   BW
W  B        B W
WBBBBB  B    BW
W B B     B   W
W   B  B BBBB W
WBBB B    BB  W
WB     B B B  W
W  B  B B   B W
WWWWWWWWWWWWWWW