WWWWWWWWWWWWWWW
W  BB         W
W  B          W
W             W
W             W
W             W
W             W
W           B W
W           B W
WWWWWWWWWWWWWWW