WWWWWWWWWWWWWWW
W   BB       BW
WB B B   B  B W
W B  B  B BB  W
WB B          W
W B B  B  B BBW
WBB B      B  W
W   BB B  B   W
W  B    B  BB W
WWWWWWWWWWWWWWW