WWWWWWWWWWWWWWW
W             W
W             W
W             W
W             W
W   B         W
W   B         W
W   B       B W
W           B W
WWWWWWWWWWWWWWW