WWWWWWWWWWWWWWW
W  BB         W
W  B          W
W             W
W             W
W             W
W             W
W             W
W   B B  B    W
WWWWWWWWWWWWWWW