WWWWWWWWWWWWWWW
W  BB  B  BB  W
W BB  B B   B W
WB   B     B  W
WBB B       B W
W B   B   BB  W
WB  BB  BB  BBW
W BB       B  W
W   B B  B B  W
WWWWWWWWWWWWWWW